%%%%%%%%%%%%%%%%%%%%
%.   %        %   .%
% %% % %%%%%% % %% %
% %              % %
% % %% %%  %% %% % %
%      %G  G%      %
% % %% %%%%%% %% % %
% %              % %
% %% % %%%%%% % %% %
%.   %   P    %   .%
%%%%%%%%%%%%%%%%%%%%
